1111111111111111111
1000000000011110000
1110111111010000111
1110111001010111011
1000000011010110011
1111111010010000111
1000011010110111011
1011001010010000001
1000011011000101011
1011111010011101011
1000000011111101011
1011111110000011011
1000001111111011101
1111101110001000101
1111100000001110101
1111101111001110101
1110001110000010001
1000100100101000111
1111111111111111111